
9,9,9,9,9,9,9,9,9,9,9,9,9,9,9,9,1,
9,9,9,9,9,9,9,9,9,9,9,9,9,9,9,9,1,
9,9,9,9,9,9,9,9,9,9,9,9,9,9,9,9,1,
9,9,9,9,9,9,9,9,9,9,9,9,9,9,9,9,1,
9,9,9,9,9,9,9,9,9,9,9,9,9,9,9,9,1,
9,9,9,9,9,9,9,9,9,9,9,9,9,9,9,9,1,
9,9,9,9,9,9,9,9,9,9,9,9,9,9,9,9,1,
9,9,9,9,9,9,9,9,9,9,9,9,9,9,9,9,1,
9,9,9,9,9,9,9,9,9,9,9,9,9,9,9,9,1,
9,9,9,9,9,9,9,9,9,9,9,9,9,9,9,9,1,
9,9,9,9,9,9,9,9,9,9,9,9,9,9,9,9,1,
9,9,9,9,9,91,9,9,9,9,9,9,9,9,9,9,1,
9,9,9,9,9,9,9,9,9,9,9,9,9,9,93,9,1,
0,0,0,0,0,0,0,0,0,0,0,0,0,0,0,0,1,